spcode	genus	species	family
*	Unidentified	species	NA
ACACME	Acacia	melanoceras	Fabaceae:mimos.
ACALDI	Acalypha	diversifolia	Euphorbiaceae
ACALMA	Acalypha	macrostachya	Euphorbiaceae
ADE1TR	Adelia	triloba	Euphorbiaceae
AEGIPA	Aegiphila	panamensis	Verbenaceae
ALBIAD	Albizia	adinocephala	Fabaceae:mimos.
ALBIPR	Albizia	procera	Fabaceae:mimos.
ALCHCO	Alchornea	costaricensis	Euphorbiaceae
ALIBED	Alibertia	edulis	Rubiaceae
ALSEBL	Alseis	blackiana	Rubiaceae
AMAICO	Amaioua	corymbosa	Rubiaceae
ANACEX	Anacardium	excelsum	Anacardiaceae
ANDIIN	Andira	inermis	Fabaceae:faboid.
ANN1	(Annonaceae)	sp.1	Annonaceae
ANNOHA	Annona	hayesii	Annonaceae
ANNOPU	Annona	purpurea	Annonaceae
ANNOSP	Annona	spraguei	Annonaceae
ANTITR	Antirhea	trichantha	Rubiaceae
APHEDE	Aphelandra	scabra	Acanthaceae
ARDIRE	Ardisia	revoluta	Myrsinaceae
AST2GR	Astronium	graveolens	Anacardiaceae
BACTBA	Bactris	barronis	Arecaceae
BACTC2	Bactris	coloradonis	Arecaceae
BACTMA	Bactris	major	Arecaceae
BANAGU	Banara	guianensis	Flacourtiaceae
BROSAL	Brosimum	alicastrum	Moraceae
BUNCOD	Bunchosia	odorata	Malpighiaceae
BURSSI	Bursera	simaruba	Burseraceae
CAL1WA	Calycolpus	warszewiczianus	Myrtaceae
CAL2CA	Calycophyllum	candidissimum	Rubiaceae
CAPPFR	Capparis	frondosa	Capparidaceae
CAS1MO	Cassia	moschata	Fabaceae:caesal.
CASEA1	Casearia	arguta	Flacourtiaceae
CASEAR	Casearia	arborea	Flacourtiaceae
CASECO	Casearia	commersoniana	Flacourtiaceae
CASEGU	Casearia	guianensis	Flacourtiaceae
CASESY	Casearia	sylvestris	Flacourtiaceae
CASSEL	Cassipourea	elliptica	Rhizophoraceae
CAVAPL	Cavanillesia	platanifolia	Bombacaceae
CECRLO	Cecropia	longipes	Cecropiaceae
CECROB	Cecropia	obtusifolia	Cecropiaceae
CECRPE	Cecropia	peltata	Cecropiaceae
CEDROD	Cedrela	odorata	Meliaceae
CHOMSP	Chomelia	spinosa	Rubiaceae
CHR2AR	Chrysophyllum	argenteum	Sapotaceae
CHR2CA	Chrysophyllum	cainito	Sapotaceae
CLAVME	Clavija	mezii	Theophrastaceae
COCCPA	Coccoloba	padiformis	Polygonaceae
COLUGL	Colubrina	glandulosa	Rhamnaceae
COLUHE	Colubrina	heteroneura	Rhamnaceae
COPAAR	Copaifera	aromatica	Fabaceae:caesal.
CORDAL	Cordia	alliodora	Boraginaceae
COU2CU	Coussarea	curvigemmia	Rubiaceae
CRYOWA	Cryosophila	warscewiczii	Arecaceae
CUPACI	Cupania	cinerea	Sapindaceae
CUPALA	Cupania	latifolia	Sapindaceae
CUPARU	Cupania	rufescens	Sapindaceae
CUPASC	Cupania	scrobiculata	Sapindaceae
CUPASY	Cupania	sylvatica	Sapindaceae
DALBRE	Dalbergia	retusa	Fabaceae:faboid.
DENDAR	Dendropanax	arboreus	Araliaceae
DIPHRO	Diphysa	robinioides	Fabaceae:faboid.
ELAEOL	Elaeis	oleifera	Arecaceae
ERY2PA	Erythroxylum	panamense	Erythroxylaceae
EUGECO	Eugenia	coloradoensis	Myrtaceae
EUGEPR	Eugenia	principium	Myrtaceae
EUGESA	Eugenia	salamensis	Myrtaceae
FARAOC	Faramea	occidentalis	Rubiaceae
FICUBU	Ficus	bullenei	Moraceae
FICUCI	Ficus	citrifolia	Moraceae
FICUIN	Ficus	insipida	Moraceae
FICUMA	Ficus	maxima	Moraceae
FISSFE	Fissicalyx	fendleri	Fabaceae:faboid.
GENIAM	Genipa	americana	Rubiaceae
GUARGL	Guarea	glabra	Meliaceae
GUARGR	Guarea	grandifolia	Meliaceae
GUAZUL	Guazuma	ulmifolia	Sterculiaceae
HEISCO	Heisteria	concinna	Olacaceae
HIRTAM	Hirtella	americana	Chrysobalanaceae
HIRTRA	Hirtella	racemosa	Chrysobalanaceae
HYMECO	Hymenaea	courbaril	Fabaceae:caesal.
INGAFA	Inga	laurina	Fabaceae:mimos.
INGAPU	Inga	punctata	Fabaceae:mimos.
INGAVE	Inga	vera	Fabaceae:mimos.
IXORFL	Ixora	floribunda	Rubiaceae
JAC1CA	Jacaranda	caucana	Bignoniaceae
LACIAG	Lacistema	aggregatum	Flacourtiaceae
LAFOPU	Lafoensia	punicifolia	Lythraceae
LINDLA	Lindackeria	laurina	Flacourtiaceae
LONCLA	Lonchocarpus	latifolius	Fabaceae:faboid.
LOPIDA	Lopimia	dasypetala	Malvaceae
LUEHSE	Luehea	seemannii	Tiliaceae
LUEHSP	Luehea	speciosa	Tiliaceae
MACLTI	Chlorophora	tinctoria	Moraceae
MACRGL	Macrocnemum	roseum	Rubiaceae
MANGIN	Mangifera	indica	Anacardiaceae
MARGNO	Margaritaria	nobilis	Euphorbiaceae
MATAGL	Matayba	glaberrima	Sapindaceae
MICOAR	Miconia	argentea	Melastomataceae
MICOBO	Miconia	minutiflora	Melastomataceae
MICOIM	Miconia	impetiolaris	Melastomataceae
MYRCGA	Myrcia	gatunensis	Myrtaceae
MYRILO	Myriocarpa	longipes	Urticaceae
MYROFR	Myrospermum	frutescens	Fabaceae:faboid.
NECTGL	Nectandra	lineata	Lauraceae
NECTMA	Nectandra	martinicensis	Lauraceae
NEEA2	Neea	sp.2	Nyctaginaceae
NEEADE	Neea	delicatula	Nyctaginaceae
OCHRPY	Ochroma	pyramidale	Bombacaceae
OCOTRU	Ocotea	rubrinervis	Lauraceae
OENOMA	Oenocarpus	mapora	Arecaceae
ORMOMA	Ormosia	macrocalyx	Fabaceae:faboid.
OURALU	Ouratea	lucens	Ochnaceae
PALIGU	Palicourea	guianensis	Rubiaceae
PHOECI	Phoebe	cinnamomifolia	Lauraceae
PICRLA	Picramnia	latifolia	Picramniaceae
PIPEA1	Piper	arboreum	Piperaceae
PIPEAE	Piper	aequale	Piperaceae
PIPECO	Piper	cordulatum	Piperaceae
PIPECU	Piper	culebranum	Piperaceae
PIPEGR	Piper	grande	Piperaceae
PIPEHI	Piper	hispidum	Piperaceae
PIPERE	Piper	reticulatum	Piperaceae
PIT1RU	Cojoba	rufescens	Fabaceae:mimos.
POCHQU	Pachira	quinata	Bombacaceae
POCHSE	Pachira	sessilis	Bombacaceae
POSOLA	Posoqueria	latifolia	Rubiaceae
POUTCA	Pouteria	campechiana	Sapotaceae
PROCCR	Prockia	crucis	Flacourtiaceae
PROTTE	Protium	tenuifolium	Burseraceae
PSE1SE	Pseudobombax	septenatum	Bombacaceae
PSYCAC	Psychotria	acuminata	Rubiaceae
PSYCG3	Psychotria	grandis	Rubiaceae
PSYCHO	Psychotria	horizontalis	Rubiaceae
PSYCMA	Psychotria	marginata	Rubiaceae
RANDFO	Rosenbergiodendron	formosum	Rubiaceae
RAUVLI	Rauvolfia	littoralis	Apocynaceae
RINOLI	Rinorea	lindeniana	Violaceae
SAP1SA	Sapindus	saponaria	Sapindaceae
SCH1ZO	Attalea	butyracea	Arecaceae
SCH2MO	Schefflera	morototoni	Araliaceae
SENNDA	Senna	dariensis	Fabaceae:caesal.
SIPAPA	Siparuna	pauciflora	Monimiaceae
SLOATE	Sloanea	terniflora	Elaeocarpaceae
SOLAEX	Solanum	extensum	Solanaceae
SOLAHA	Solanum	hayesii	Solanaceae
SOROAF	Sorocea	affinis	Moraceae
SPONMO	Spondias	mombin	Anacardiaceae
SPONRA	Spondias	radlkoferi	Anacardiaceae
STEMGR	Stemmadenia	grandiflora	Apocynaceae
STERAP	Sterculia	apetala	Sterculiaceae
STYLST	Stylogyne	standleyi	Myrsinaceae
SWARS1	Swartzia	simplex_var.grandiflora	Fabaceae:caesal.
SWARS2	Swartzia	simplex_var.ochnacea	Fabaceae:caesal.
SWIEMA	Swietenia	macrophylla	Meliaceae
TAB1RO	Tabebuia	rosea	Bignoniaceae
TERMAM	Terminalia	amazonia	Combretaceae
TERMOB	Terminalia	oblonga	Combretaceae
TERNTE	Ternstroemia	tepezapote	Theaceae
TET4JO	Tetrathylacium	johansenii	Flacourtiaceae
THEVAH	Thevetia	ahouai	Apocynaceae
TRI2HI	Trichilia	hirta	Meliaceae
TRI2PL	Trichilia	pleeana	Meliaceae
TRI2TO	Trichilia	martiana	Meliaceae
TRI2TU	Trichilia	tuberculata	Meliaceae
TRI4GA	Trichospermum	galeottii	Tiliaceae
TRIPCU	Triplaris	cumingiana	Polygonaceae
TROPRA	Trophis	racemosa	Moraceae
TURNPA	Turnera	panamensis	Turneraceae
UN2_CO	Unidentified	(howard)sp.2	NA
VERNPA	Vernonanthura	patens	Asteraceae
VITECO	Vitex	cooperi	Verbenaceae
XYL1FR	Xylopia	frutescens	Annonaceae
ZANTP1	Zanthoxylum	panamense	Rutaceae
ZANTPR	Zanthoxylum	juniperinum	Rutaceae
ZUELGU	Zuelania	guidonia	Flacourtiaceae
